##########
#b  X   X#
#       g#
#   C   g#
#  s    g#
#      # #
#  C  S#C#
#  S  O# #
#  X   #E#
##########
