OOOOOOOOOO
OOOOOOOOOO
##########
#b   X X #
# sO   # #
#E   C C #
######   #
OOOOO#####
OOOOOOOOOO
OOOOOOOOOO
