##########
#OggggXXO#
#gggggggg#
#gggggggg#
#ggg#ggCg#
##gggSggO#
#gggggggg#
#gg#ggCgg#
#Eggg#ggO#
##########