##########
#    X   #
#        #
###%%#####
#b    C  #
# C ggg  #
#  s    X#
# s # ####
#E t#t m #
##########